Button	KEYWORD1
SetPinNumber	KEYWORD2
Update	KEYWORD2
GetState	KEYWORD2
HasChanged	KEYWORD2
HasChangedUp	KEYWORD2
HasChangedDown	KEYWORD2

LED	KEYWORD1
SetPinNumber	KEYWORD2
SetState	KEYWORD2
SetOn	KEYWORD2
SetOff	KEYWORD2
Toggle	KEYWORD2
SetBlink	KEYWORD2

PPMReceiver	KEYWORD1
SetLowPassFilter	KEYWORD2
GetLowPassFilter	KEYWORD2
Update	KEYWORD2
ReadChannel	KEYWORD2

createTimeString	KEYWORD2
createDateString	KEYWORD2
createFloatString	KEYWORD2
createIntString	KEYWORD2
mapf	KEYWORD2
